NO ./textures/pizza.xpm
SO ./textures/road.xpm
WE ./textures/wall2.xpm
EA ./textures/wall2.xpm
F 220,100,0
C 225,30,0
awdwadwadwadwadwadwadwa
       11111111111111111111111111
       10000000000110000000000001
       10011000001110000000000001
       10010000000000000000000001
111111110110000011100000000000001
100000000011000001110111111111111
11110111111111011100000010001
11110111111111011101010010001
11000000110101011100000010001
10000000000000001100000N10001
10000000000000001101010010001
110000011101010111110111100111
11110111 1110101 101111010001
11111111 1111111 111111111111
