NO ./textures/purple_turtle.xpm
SO ./textures/fan.xpm	
WE ./textures/sally.xpm
EA ./textures/flash.xpm
F 100,100,100 
C 173,216,230

1111111
1101001
1000E01
1001001
1111111