NO ./textures/pizza.xpm
SO   ./textures/road.xpm	
WE ./textures/dwall2.xpm
EA ./  textures/wall2.xpm
F 100,170,256 
C     150,15a0,150    
awdwadwadwadwadwadwadwa
       1111111111111111111111111
       10000000000011000000000001
       10011000011100000000000001
       100100000000000000000000012
111111111100000111000000000000011
100000000011000001110111111111111
11110111111111011100000010W001
11110111111111011101010010001
110000001101d01011100000000111
10000000000000001100010N0001
1000000000000000110101000111
110000011101010111110111000111
11110111 1110101 101111010001
11111111 1111111 111111111111
