NO ./textures/purple_turtle.xpm
SO ./textures/fan.xpm	
WE ./textures/martin.xpm
EA ./textures/flash.xpm
F 100,100,100 
C 173,216,230

111111111
1100001111
1000W01011
10000001111
11111111111