1111111111111111111111111
1000000000110000000000001
1011000001110000000000001
100100000000000000000000111111111
111111111011000001110000000000001
100010000011000001110011111011111
11111011111111011100000010001
11111011111111011101000010101
11001010111111111100000010001
100000000000000011000P0010001
10000000000000001101010010001
1100000111010101111101110000111
11110111111010110111101000111
111111111111111111111111111