1111111111111111111111111
1000000000110000000000001
1011000001110000000000001
1001000000000000000000001
111111111011000001110000000000001
100010000011000001110011111111111
11111011111111011100000010001
11111011111111011101000010001
11001010111111111100000010001
100000000000000011000P0010001
10000000000000001101010010001
1100000111010101111101111000111
111101111110101101111010001
111111111111111111111111111