NO ./textures/pizza.xpm
SO ./textures/road.xpm	
WE ./textures/wall2.xpm
EA ./textures/wall2.xpm
F 100,170,255 
C 150,150,150

111111111
1100001111
1000W001011
10000001111
11111111111