NO ./textures/flash.xpm
SO ./textures/sally.xpm
WE ./textures/martin.xpm
EA ./textures/fan.xpm

1111111111
10001100E1
1100100111
1100000001
1001000111
1111111111