NO ./textures/flash.xpm
SO ./textures/sally.xpm
WE ./textures/martin.xpm
EA ./textures/fan.xpm

F 243,100,100
C 243,100,100

1111111111
1011110001
111 1100011
11111E0001
1001000111
1111111111